################
#..............#
#..............#
#..............#
#......####....#
#....H.........#
#..............#
#..............#
#...######.....#
#..............#
#........#######
#..H.........H.#
#..............#
#############..#
#.........H...W#
################